0000000000000000000
0000000000000000000
0000000000000000000
0000000000000000000
0000000022000000000
0000000000000000000
0022000000000022000
1122112211221122111
1111111111111111111
1111111111111111111
1111111111111111111
1111111111111111111
1111111111111111111
